1000000000000000
0000000999900000
0000000999900000
6600000999900000
0000000000000002